              4 2 2       
            3 1 1 1 4     
        9 9 4 2 2 4 3 9 9 
      |==================|
     9|##################|
     9|##################|
   4 3|########><><######|
 2 1 4|####><##><########|
 2 1 2|####><><##><><####|
 4 1 2|########><##><####|
   3 4|######><><########|
     9|##################|
     9|##################|
      |==================|