3
111111111
111111111
111100111
110101111
110010011
111101011
111001111
111111111
111111111