3
001001000
011011000
011011000
011011000
001011001
001001011
111111111
001111111
000111110