          3     4         
        1 1 8 3 3 9 3 4 4 
      |==================|
   1 1|><><##><><##><><><|
   2 2|><####><####><><><|
   2 2|><####><####><><><|
   2 2|><####><####><><><|
 1 2 1|><><##><####><><##|
 1 1 2|><><##><><##><####|
     9|##################|
     7|><><##############|
     5|><><><##########><|
      |==================|