                  1   2 1     
        1 2 1   1 1 1 3 1   1 
        1 2 1 4 6 6 8 1 1 1 1 
      |======================|
   3 2|######><><####><><><><|
     1|><##><><><><><><><><><|
   2 1|><><><><####><><##><><|
     2|><><><><><><####><><><|
     3|><><><><><><######><><|
   3 1|><><><><######><><><##|
   1 7|##><><##############><|
 1 5 1|><##><##########><><##|
   1 5|><##><##########><><><|
     5|><><##########><><><><|
     4|><><><><########><><><|
      |======================|