4
11100110000
01000000000
00001100100
00000011000
00000011100
00001110001
10011111110
01011111001
01011111000
00111110000
00011111000