          3 5   5 6 5 4 2 1 
      1 2 3 311 3 2 1 1 1 1 
    |======================|
   8|><><><################|
   8|><><################><|
   7|><><##############><><|
   7|><><##############><><|
   5|><><><##########><><><|
 1 1|><><><><##><##><><><><|
   1|><><><><##><><><><><><|
   1|><><><><##><><><><><><|
   4|><><########><><><><><|
   6|><############><><><><|
  11|######################|
    |======================|