4
00011111111
00111111110
00111111100
00111111100
00011111000
00001010000
00001000000
00001000000
00111100000
01111110000
11111111111