5
000000111111000
000010001000000
001111111010000
000010000010010
001111110010010
000011110010111
000010110000010
100010111111010
111000010010111
100001111111000
100000110010000
100011111011000
111111111011010
000110000001000
000000000111111