              1     1 1   3 1 1 1       
              1 1   2 1 1 1 1 4 1 1 6 1 
            1 1 1 7 1 4 1 1 1 6 1 1 1 1 
          6 1 1 2 3 2 4 9 2 1 1 4 1 1 1 
        |==============================|
       6|><><><><><><############><><><|
     1 1|><><><><##><><><##><><><><><><|
     7 1|><><##############><##><><><><|
   1 1 1|><><><><##><><><><><##><><##><|
   6 1 1|><><############><><##><><##><|
   4 1 3|><><><><########><><##><######|
   1 2 1|><><><><##><####><><><><><##><|
 1 1 6 1|##><><><##><############><##><|
 3 1 1 3|######><><><><##><><##><######|
     1 7|##><><><><##############><><><|
   1 2 1|##><><><><><####><><##><><><><|
   1 5 2|##><><><##########><####><><><|
   9 2 1|##################><####><##><|
     2 1|><><><####><><><><><><##><><><|
       6|><><><><><><><><><############|
        |==============================|