5
111110000000001
011100000000010
001000000000100
000000000000000
000000000000000
000001111100000
000000111100000
000000011100000
000000001100000
000000000100000
111110000000000
111110000000000
111110000000100
111110000001110
111110000011111