      1 2 3 2 1               1 1 1 
      5 5 5 5 5 1 2 3 4 5 1 2 3 2 1 
    |==============================|
 5 1|##########><><><><><><><><><##|
 3 1|><######><><><><><><><><><##><|
 1 1|><><##><><><><><><><><><##><><|
    |><><><><><><><><><><><><><><><|
    |><><><><><><><><><><><><><><><|
   5|><><><><><##########><><><><><|
   4|><><><><><><########><><><><><|
   3|><><><><><><><######><><><><><|
   2|><><><><><><><><####><><><><><|
   1|><><><><><><><><><##><><><><><|
   5|##########><><><><><><><><><><|
   5|##########><><><><><><><><><><|
 5 1|##########><><><><><><><##><><|
 5 3|##########><><><><><><######><|
 5 5|##########><><><><><##########|
    |==============================|